"TERYT Powiatu";"Powiat";"Województwo";"Liczba komisji";"Liczba uwzględnionych komisji";"Komisja otrzymała kart do głosowania";"Liczba wyborców uprawnionych do głosowania";"Nie wykorzystano kart do głosowania";"Liczba wyborców, którym wydano karty do głosowania w lokalu wyborczym";"Liczba wyborców, którym wysłano pakiety wyborcze";"Liczba wyborców, którym wydano karty do głosowania w lokalu wyborczym oraz w głosowaniu korespondencyjnym (łącznie)";"Liczba wyborców głosujących przez pełnomocnika";"Liczba wyborców głosujących na podstawie zaświadczenia o prawie do głosowania";"Liczba otrzymanych kopert zwrotnych";"Liczba kopert zwrotnych, w których nie było oświadczenia o osobistym i tajnym oddaniu głosu";"Liczba kopert zwrotnych, w których oświadczenie nie było podpisane";"Liczba kopert zwrotnych, w których nie było koperty na kartę do głosowania";"Liczba kopert zwrotnych, w których znajdowała się niezaklejona koperta na kartę do głosowania";"Liczba kopert na kartę do głosowania wrzuconych do urny";"Liczba kart wyjętych z urny";"W tym liczba kart wyjętych z kopert na kartę do głosowania";"Liczba kart nieważnych";"Liczba kart ważnych";"Liczba głosów nieważnych";"W tym z powodu postawienia znaku „X” obok nazwiska dwóch lub większej liczby kandydatów";"W tym z powodu niepostawienia znaku „X” obok nazwiska żadnego kandydata";"W tym z powodu postawienia znaku „X” wyłącznie obok skreślonego nazwiska kandydata";"Liczba głosów ważnych oddanych łącznie na wszystkich kandydatów";"NAWROCKI Karol Tadeusz";"TRZASKOWSKI Rafał Kazimierz"
20100;"bolesławiecki";"dolnośląskie";82;82;65042;65527;22049;42992;22;43014;71;771;21;1;0;0;0;20;43011;19;1;43010;347;178;169;0;42663;21717;20946
20200;"dzierżoniowski";"dolnośląskie";91;91;71428;71928;24815;46612;19;46631;112;669;18;3;0;0;0;15;46627;15;4;46623;426;219;207;0;46197;22827;23370
20300;"głogowski";"dolnośląskie";57;57;63121;63088;19339;43782;13;43795;47;901;13;0;0;0;0;13;43794;13;1;43793;367;193;174;0;43426;22223;21203
20400;"górowski";"dolnośląskie";35;35;24846;24781;9638;15208;9;15217;28;237;9;0;0;0;0;9;15216;9;1;15215;121;72;49;0;15094;8839;6255
20500;"jaworski";"dolnośląskie";47;47;36390;36460;12546;23843;14;23857;68;447;14;1;0;0;0;13;23857;13;1;23856;207;94;113;0;23649;12902;10747
20600;"karkonoski";"dolnośląskie";60;60;49323;49549;15662;33661;13;33674;91;2318;12;0;0;0;0;12;33672;12;0;33672;287;146;141;0;33385;12516;20869
20700;"kamiennogórski";"dolnośląskie";41;41;31101;31147;10888;20213;5;20218;49;483;5;0;0;0;0;5;20219;5;1;20218;189;107;82;0;20029;9497;10532
20800;"kłodzki";"dolnośląskie";151;151;115114;117682;38830;76282;35;76317;230;4763;35;3;0;0;3;29;76307;29;0;76307;718;367;351;0;75589;35713;39876
20900;"legnicki";"dolnośląskie";61;61;40470;41196;12452;28018;5;28023;42;327;5;0;0;0;0;5;28023;5;1;28022;228;115;113;0;27794;15599;12195
21000;"lubański";"dolnośląskie";50;50;39958;40149;13991;25967;12;25979;61;1080;12;3;0;0;0;9;25974;9;0;25974;217;113;104;0;25757;11886;13871
21100;"lubiński";"dolnośląskie";94;94;76295;76486;21740;54554;21;54575;90;1358;21;0;0;0;0;21;54572;20;2;54570;448;249;199;0;54122;29889;24233
21200;"lwówecki";"dolnośląskie";51;51;33146;33018;12560;20586;0;20586;75;527;0;0;0;0;0;0;20584;0;0;20584;175;83;92;0;20409;9863;10546
21300;"milicki";"dolnośląskie";37;37;27507;27618;9389;18118;0;18118;32;339;0;0;0;0;0;0;18116;0;0;18116;148;74;74;0;17968;9907;8061
21400;"oleśnicki";"dolnośląskie";81;81;79313;80749;24100;55213;15;55228;123;969;15;1;0;0;0;14;55224;14;2;55222;465;243;222;0;54757;25898;28859
21500;"oławski";"dolnośląskie";61;61;56214;57545;14867;41348;14;41362;58;575;14;0;0;0;0;14;41360;14;3;41357;326;185;141;0;41031;20384;20647
21600;"polkowicki";"dolnośląskie";52;52;44609;45065;13798;30809;0;30809;75;611;0;0;0;0;0;0;30809;0;2;30807;260;134;126;0;30547;19085;11462
21700;"strzeliński";"dolnośląskie";50;50;33004;33514;10145;22859;9;22868;68;329;9;0;0;0;0;9;22865;9;1;22864;192;106;86;0;22672;12761;9911
21800;"średzki";"dolnośląskie";59;59;42635;44322;11023;31612;6;31618;44;547;6;0;0;0;0;6;31617;5;0;31617;291;175;116;0;31326;16137;15189
21900;"świdnicki";"dolnośląskie";137;137;112363;113174;35517;76842;29;76871;159;1103;29;2;0;0;0;27;76869;27;4;76865;723;346;377;0;76142;35417;40725
22000;"trzebnicki";"dolnośląskie";110;110;65534;66971;17136;48397;16;48413;94;983;16;1;0;0;0;15;48410;15;6;48404;459;263;196;0;47945;24365;23580
22100;"wałbrzyski";"dolnośląskie";52;52;39777;40172;14118;25659;23;25682;87;702;23;4;0;0;0;19;25677;19;2;25675;274;138;136;0;25401;10668;14733
22200;"wołowski";"dolnośląskie";41;41;35805;35943;11448;24357;12;24369;60;347;10;0;0;0;0;10;24368;10;1;24367;229;116;113;0;24138;12997;11141
22300;"wrocławski";"dolnośląskie";133;133;124480;131387;20801;103677;33;103710;139;2152;33;3;0;0;0;30;103701;29;3;103698;979;547;432;0;102719;41671;61048
22400;"ząbkowicki";"dolnośląskie";84;84;47326;47298;17545;29780;6;29786;86;636;6;0;0;0;0;6;29785;6;0;29785;270;139;131;0;29515;15835;13680
22500;"zgorzelecki";"dolnośląskie";97;97;64665;65433;21849;42813;20;42833;75;1850;20;2;0;0;0;18;42832;18;0;42832;376;208;168;0;42456;21312;21144
22600;"złotoryjski";"dolnośląskie";46;46;31236;31312;11010;20224;0;20224;42;403;0;0;0;0;0;0;20224;0;0;20224;154;74;80;0;20070;10337;9733
26100;"Jelenia Góra";"dolnośląskie";49;49;55869;56433;16371;39497;45;39542;94;1679;44;15;0;0;0;29;39525;29;1;39524;291;139;152;0;39233;13834;25399
26200;"Legnica";"dolnośląskie";50;50;66383;66601;20797;45586;47;45633;61;900;46;10;0;0;0;36;45618;36;4;45614;395;217;178;0;45219;20461;24758
26400;"Wrocław";"dolnośląskie";331;331;473851;510438;72233;401584;350;401934;551;10479;336;22;2;2;0;310;401870;308;55;401815;4366;2427;1939;0;397449;130794;266655
26500;"Wałbrzych";"dolnośląskie";64;64;72617;72421;25431;47185;52;47237;103;1138;50;1;1;1;0;47;47233;46;4;47229;408;209;199;0;46821;17884;28937
40100;"aleksandrowski";"kujawsko-pomorskie";68;68;44240;44950;13420;30821;9;30830;77;3110;9;4;0;0;0;5;30826;5;0;30826;283;151;132;0;30543;16606;13937
40200;"brodnicki";"kujawsko-pomorskie";76;76;56719;57537;19379;37338;18;37356;68;537;18;1;0;0;0;17;37354;17;1;37353;304;170;134;0;37049;21125;15924
40300;"bydgoski";"kujawsko-pomorskie";122;122;91135;93310;23535;67598;28;67626;85;1247;25;0;0;0;0;25;67624;25;1;67623;620;337;283;0;67003;26727;40276
40400;"chełmiński";"kujawsko-pomorskie";53;53;36177;36426;13084;23093;8;23101;57;394;7;0;0;0;0;7;23100;7;1;23099;188;107;81;0;22911;11695;11216
40500;"golubsko-dobrzyński";"kujawsko-pomorskie";42;42;32728;33181;11583;21143;3;21146;53;316;3;0;0;0;0;3;21148;3;0;21148;186;88;98;0;20962;12631;8331
40600;"grudziądzki";"kujawsko-pomorskie";58;58;29228;29690;10786;18450;4;18454;33;226;4;2;0;0;0;2;18454;2;1;18453;141;89;52;0;18312;10681;7631
40700;"inowrocławski";"kujawsko-pomorskie";161;161;115008;114937;39353;75658;34;75692;123;2384;33;1;0;0;0;32;75687;31;4;75683;674;383;291;0;75009;35513;39496
40800;"lipnowski";"kujawsko-pomorskie";84;84;48070;48024;18419;29651;9;29660;88;536;8;0;0;0;0;8;29658;8;0;29658;282;144;138;0;29376;17978;11398
40900;"mogileński";"kujawsko-pomorskie";49;49;33785;33801;12359;21426;2;21428;49;273;2;1;0;0;0;1;21427;1;0;21427;239;159;80;0;21188;11437;9751
41000;"nakielski";"kujawsko-pomorskie";102;102;63241;62944;21873;41367;9;41376;82;563;9;1;0;0;0;8;41374;8;1;41373;372;191;181;0;41001;19978;21023
41100;"radziejowski";"kujawsko-pomorskie";56;56;30237;30415;10831;19403;3;19406;90;367;3;1;0;0;0;2;19405;2;4;19401;153;86;67;0;19248;12605;6643
41200;"rypiński";"kujawsko-pomorskie";59;59;32260;32260;12068;20191;4;20195;54;298;4;0;0;0;0;4;20196;4;0;20196;154;72;82;0;20042;11916;8126
41300;"sępoleński";"kujawsko-pomorskie";53;53;29616;29290;11190;18426;5;18431;60;336;5;1;0;0;0;4;18430;4;1;18429;150;87;63;0;18279;9613;8666
41400;"świecki";"kujawsko-pomorskie";115;115;70748;71187;25353;45395;16;45411;101;789;16;0;0;0;0;16;45410;16;1;45409;412;218;194;0;44997;23308;21689
41500;"toruński";"kujawsko-pomorskie";91;91;81622;83196;23842;57787;12;57799;106;847;11;1;0;0;0;10;57798;10;2;57796;513;274;239;0;57283;27457;29826
41600;"tucholski";"kujawsko-pomorskie";60;60;35293;35957;11594;23699;8;23707;54;510;7;0;0;0;0;7;23706;7;1;23705;231;131;100;0;23474;13929;9545
41700;"wąbrzeski";"kujawsko-pomorskie";34;34;24182;24399;9247;14935;4;14939;20;227;4;1;0;0;0;3;14938;3;1;14937;112;66;46;0;14825;7784;7041
41800;"włocławski";"kujawsko-pomorskie";102;102;65033;65492;23022;42011;8;42019;110;1328;7;0;0;0;0;7;42017;7;0;42017;396;204;192;0;41621;24817;16804
41900;"żniński";"kujawsko-pomorskie";98;98;51527;51891;17397;34129;16;34145;58;536;16;3;0;0;0;13;34141;13;1;34140;356;178;178;0;33784;17653;16131
46100;"Bydgoszcz";"kujawsko-pomorskie";208;208;234998;241446;58391;176614;236;176850;286;4368;226;23;2;0;1;200;176814;200;13;176801;1491;830;661;0;175310;62363;112947
46200;"Grudziądz";"kujawsko-pomorskie";55;55;62091;62101;20803;41288;22;41310;61;1079;20;0;0;0;0;20;41306;19;1;41305;320;168;152;0;40985;16232;24753
46300;"Toruń";"kujawsko-pomorskie";126;126;139417;143940;31960;107472;94;107566;138;3106;90;8;0;1;0;82;107533;82;12;107521;980;530;450;0;106541;38563;67978
46400;"Włocławek";"kujawsko-pomorskie";69;69;76480;75575;25290;51190;34;51224;152;1017;29;2;0;0;1;26;51215;26;5;51210;433;241;192;0;50777;20049;30728
60100;"bialski";"lubelskie";134;134;83067;82225;27715;55352;18;55370;110;1228;17;0;0;0;0;17;55369;17;0;55369;495;274;221;0;54874;39914;14960
60200;"biłgorajski";"lubelskie";112;112;76284;74673;25593;50690;9;50699;224;826;9;0;0;0;0;9;50698;9;2;50696;389;173;216;0;50307;38313;11994
60300;"chełmski";"lubelskie";107;107;57841;57708;21911;35930;57;35987;79;501;55;1;3;0;0;51;35981;51;1;35980;301;150;151;0;35679;26459;9220
60400;"hrubieszowski";"lubelskie";87;87;47085;45816;18783;28301;13;28314;90;590;13;0;0;0;0;13;28314;13;2;28312;227;124;103;0;28085;20078;8007
60500;"janowski";"lubelskie";45;45;34249;33739;9492;24772;5;24777;174;385;5;0;0;0;0;5;24775;5;3;24772;163;88;75;0;24609;20735;3874
60600;"krasnostawski";"lubelskie";101;101;47889;47441;17631;30258;31;30289;127;483;31;4;0;1;0;26;30282;26;1;30281;231;115;116;0;30050;20635;9415
60700;"kraśnicki";"lubelskie";95;95;70402;69213;23834;46568;10;46578;178;540;10;0;0;0;0;10;46574;10;1;46573;422;249;173;0;46151;33617;12534
60800;"lubartowski";"lubelskie";98;98;65851;66134;19224;46627;6;46633;155;695;6;0;0;0;0;6;46632;6;2;46630;420;217;203;0;46210;33660;12550
60900;"lubelski";"lubelskie";144;144;120738;123544;29963;90787;21;90808;226;1139;20;0;0;0;0;20;90804;20;5;90799;884;458;426;0;89915;60739;29176
61000;"łęczyński";"lubelskie";65;65;42143;42301;12173;29970;8;29978;49;446;8;0;0;0;0;8;29976;8;0;29976;260;148;112;0;29716;21834;7882
61100;"łukowski";"lubelskie";133;133;77538;76888;21606;55928;10;55938;98;774;9;0;0;0;0;9;55938;9;1;55937;452;234;218;0;55485;43799;11686
61200;"opolski";"lubelskie";71;71;44376;44055;14836;29540;5;29545;87;460;5;1;0;0;0;4;29543;4;0;29543;271;141;130;0;29272;21331;7941
61300;"parczewski";"lubelskie";46;46;25960;25623;8894;17066;7;17073;60;382;5;0;0;0;0;5;17070;5;0;17070;139;67;72;0;16931;11851;5080
61400;"puławski";"lubelskie";109;109;86348;86115;24692;61654;53;61707;205;1989;51;1;0;0;0;50;61704;50;1;61703;607;315;292;0;61096;37940;23156
61500;"radzyński";"lubelskie";77;77;44315;43428;14495;29820;10;29830;76;431;10;1;0;0;1;8;29827;8;0;29827;236;132;104;0;29591;22526;7065
61600;"rycki";"lubelskie";81;81;41102;40832;11285;29817;3;29820;73;588;3;0;0;0;0;3;29820;3;1;29819;245;126;119;0;29574;20566;9008
61700;"świdnicki";"lubelskie";63;63;52866;53710;15002;37864;26;37890;112;596;25;3;0;0;0;22;37885;22;1;37884;369;191;178;0;37515;23842;13673
61800;"tomaszowski";"lubelskie";113;113;62514;61084;23135;39376;11;39387;154;728;7;1;0;0;0;6;39381;6;1;39380;287;158;129;0;39093;28621;10472
61900;"włodawski";"lubelskie";52;52;29112;28634;10395;18717;9;18726;56;545;9;1;0;0;0;8;18724;7;0;18724;176;108;68;0;18548;11446;7102
62000;"zamojski";"lubelskie";153;153;81223;80168;28026;53195;31;53226;212;1155;29;2;1;0;0;26;53220;26;0;53220;413;223;190;0;52807;40329;12478
66100;"Biała Podlaska";"lubelskie";29;29;41298;40716;12207;29091;30;29121;71;711;30;4;0;0;0;26;29117;26;14;29103;239;119;120;0;28864;16931;11933
66200;"Chełm";"lubelskie";36;36;45013;44001;15853;29160;33;29193;45;414;33;5;0;0;0;28;29187;28;1;29186;217;137;80;0;28969;15610;13359
66300;"Lublin";"lubelskie";217;217;252384;255018;62156;190228;216;190444;326;4077;209;14;2;0;0;193;190392;190;20;190372;1807;1033;774;0;188565;92136;96429
66400;"Zamość";"lubelskie";35;35;45854;44705;15406;30448;38;30486;80;825;34;4;0;0;0;30;30475;30;1;30474;208;108;100;0;30266;17207;13059
80100;"gorzowski";"lubuskie";70;70;53493;54467;16602;36891;3;36894;42;769;3;0;0;0;0;3;36894;3;2;36892;339;163;176;0;36553;15661;20892
80200;"krośnieński";"lubuskie";63;63;39382;39855;14269;25113;0;25113;44;622;0;0;0;0;0;0;25113;0;0;25113;218;113;105;0;24895;10433;14462
80300;"międzyrzecki";"lubuskie";66;66;41793;42269;14289;27504;15;27519;65;985;14;4;0;2;0;8;27509;8;0;27509;240;123;117;0;27269;11513;15756
80400;"nowosolski";"lubuskie";65;65;61251;62097;20400;40851;55;40906;81;835;52;8;2;0;1;41;40886;41;3;40883;391;219;172;0;40492;18434;22058
80500;"słubicki";"lubuskie";39;39;33823;35120;11393;22431;3;22434;55;969;3;0;0;0;0;3;22434;3;0;22434;197;81;116;0;22237;9179;13058
80600;"strzelecko-drezdenecki";"lubuskie";53;53;35020;35488;12885;22134;10;22144;67;499;10;2;0;0;0;8;22142;8;0;22142;131;60;71;0;22011;10295;11716
80700;"sulęciński";"lubuskie";49;49;25779;26035;8940;16839;3;16842;27;571;3;0;0;0;0;3;16840;3;0;16840;157;84;73;0;16683;8344;8339
80800;"świebodziński";"lubuskie";59;59;40219;40967;13331;26888;13;26901;37;546;13;0;0;0;0;13;26901;13;0;26901;259;140;119;0;26642;11974;14668
80900;"zielonogórski";"lubuskie";78;78;55481;56478;17573;37906;16;37922;66;933;16;0;0;0;0;16;37922;16;2;37920;365;187;178;0;37555;15278;22277
81000;"żagański";"lubuskie";80;80;55476;55603;20542;34934;30;34964;75;746;29;5;0;0;0;24;34958;24;1;34957;339;181;158;0;34618;16425;18193
81100;"żarski";"lubuskie";82;82;68056;68337;25179;42877;28;42905;67;877;28;2;0;0;0;26;42895;26;0;42895;345;165;180;0;42550;18257;24293
81200;"wschowski";"lubuskie";44;44;27786;28378;9478;18308;6;18314;30;447;6;0;0;0;0;6;18313;6;2;18311;144;75;69;0;18167;9759;8408
86100;"Gorzów Wielkopolski";"lubuskie";68;68;83717;83571;25377;58340;38;58378;90;1489;36;2;0;0;0;34;58373;34;1;58372;441;229;212;0;57931;22231;35700
86200;"Zielona Góra";"lubuskie";86;86;99723;102390;23249;76472;72;76544;160;1783;70;6;0;0;0;64;76532;64;7;76525;669;360;309;0;75856;24199;51657
100100;"bełchatowski";"łódzkie";79;79;83375;82933;22813;60560;20;60580;114;1117;18;1;0;0;0;17;60576;17;8;60568;641;394;247;0;59927;40664;19263
100200;"kutnowski";"łódzkie";86;86;71173;70918;22790;48383;24;48407;127;677;24;1;0;0;0;23;48405;23;2;48403;404;216;188;0;47999;29003;18996
100300;"łaski";"łódzkie";60;60;37609;38371;9826;27783;4;27787;61;477;4;0;0;0;0;4;27787;4;0;27787;286;168;118;0;27501;16142;11359
100400;"łęczycki";"łódzkie";53;53;37864;38019;11771;26093;11;26104;57;283;11;0;1;0;0;10;26102;10;1;26101;226;106;120;0;25875;17413;8462
100500;"łowicki";"łódzkie";83;83;58873;59260;16304;42570;7;42577;75;597;6;0;0;0;0;6;42575;6;6;42569;400;209;191;0;42169;27626;14543
100600;"łódzki wschodni";"łódzkie";90;90;56752;58331;11716;45035;17;45052;88;794;16;1;0;0;0;15;45048;15;5;45043;417;244;173;0;44626;22909;21717
100700;"opoczyński";"łódzkie";95;95;56477;56238;14368;42099;10;42109;91;549;10;1;0;1;0;8;42107;8;5;42102;334;179;155;0;41768;31162;10606
100800;"pabianicki";"łódzkie";71;71;87894;90551;20093;67822;21;67843;204;1359;19;4;0;0;0;15;67829;15;5;67824;700;428;272;0;67124;30035;37089
100900;"pajęczański";"łódzkie";45;45;38582;38509;11301;27281;4;27285;117;410;4;0;0;0;0;4;27284;4;0;27284;252;145;107;0;27032;19037;7995
101000;"piotrkowski";"łódzkie";95;95;69201;70416;17889;51314;3;51317;99;900;3;0;0;0;0;3;51316;3;3;51313;433;217;216;0;50880;37449;13431
101100;"poddębicki";"łódzkie";55;55;31451;32207;8883;22568;0;22568;46;577;0;0;0;0;0;0;22568;0;0;22568;173;100;73;0;22395;14258;8137
101200;"radomszczański";"łódzkie";109;109;83505;83855;25209;58296;22;58318;205;1049;22;2;0;0;0;20;58314;20;3;58311;488;275;213;0;57823;36496;21327
101300;"rawski";"łódzkie";38;38;35742;36218;9906;25837;4;25841;37;351;4;0;0;0;0;4;25841;4;2;25839;237;126;111;0;25602;17838;7764
101400;"sieradzki";"łódzkie";101;101;87895;87960;25964;61930;24;61954;117;674;24;4;0;0;0;20;61948;20;4;61944;563;308;255;0;61381;39352;22029
101500;"skierniewicki";"łódzkie";42;42;28464;29355;6607;21858;6;21864;35;256;6;0;0;0;0;6;21863;6;1;21862;186;92;94;0;21676;16036;5640
101600;"tomaszowski";"łódzkie";92;92;84754;85408;22297;62455;29;62484;131;915;29;0;0;0;0;29;62482;29;3;62479;503;306;197;0;61976;38058;23918
101700;"wieluński";"łódzkie";88;88;57128;57096;17150;39983;5;39988;80;591;5;1;0;0;0;4;39983;4;0;39983;359;199;160;0;39624;24251;15373
101800;"wieruszowski";"łódzkie";45;45;31674;32091;10003;21670;1;21671;38;290;1;0;0;0;0;1;21671;1;1;21670;208;108;100;0;21462;13457;8005
101900;"zduńskowolski";"łódzkie";43;43;48098;48197;13624;34472;7;34479;62;479;7;0;0;0;0;7;34478;7;1;34477;306;179;127;0;34171;19329;14842
102000;"zgierski";"łódzkie";136;136;124278;127190;30041;94236;36;94272;164;1866;35;3;0;0;0;32;94266;32;5;94261;911;533;378;0;93350;43953;49397
102100;"brzeziński";"łódzkie";45;45;23311;23742;6028;17283;1;17284;42;234;1;0;0;0;0;1;17283;1;1;17282;161;85;76;0;17121;10594;6527
106100;"Łódź";"łódzkie";323;323;485251;488805;116723;368542;421;368963;510;7807;390;11;5;5;2;367;368871;367;34;368837;3664;2099;1565;0;365173;125893;239280
106200;"Piotrków Trybunalski";"łódzkie";41;41;51906;51559;14764;37151;24;37175;76;700;23;0;1;0;0;22;37173;22;1;37172;371;208;163;0;36801;18520;18281
106300;"Skierniewice";"łódzkie";29;29;34087;34285;8043;26043;16;26059;42;394;14;1;0;0;0;13;26049;13;1;26048;295;170;125;0;25753;12384;13369
120100;"bocheński";"małopolskie";86;86;80545;81673;19882;60660;18;60678;115;731;18;2;0;1;0;15;60671;15;2;60669;507;269;238;0;60162;42790;17372
120200;"brzeski";"małopolskie";77;77;69818;69718;21483;48336;21;48357;91;721;21;1;0;0;0;20;48353;20;2;48351;377;172;205;0;47974;35323;12651
120300;"chrzanowski";"małopolskie";93;93;90357;91067;26150;64206;50;64256;99;1016;47;3;0;0;0;44;64246;44;1;64245;544;300;244;0;63701;31477;32224
120400;"dąbrowski";"małopolskie";63;63;44602;44041;16339;28259;12;28271;59;350;12;0;0;0;1;11;28269;11;0;28269;215;103;112;0;28054;22368;5686
120500;"gorlicki";"małopolskie";99;99;80947;80840;25385;55561;38;55599;145;1060;37;4;0;0;0;33;55592;33;2;55590;399;221;178;0;55191;39046;16145
120600;"krakowski";"małopolskie";265;265;216314;224425;45266;171053;80;171133;387;2652;76;7;0;0;0;69;171112;69;8;171104;1633;875;758;0;169471;95586;73885
120700;"limanowski";"małopolskie";115;115;96556;97124;24900;71656;116;71772;90;1071;115;4;0;0;0;111;71766;111;1;71765;529;244;285;0;71236;58192;13044
120800;"miechowski";"małopolskie";89;89;37030;37527;10955;26075;1;26076;56;381;1;0;0;0;0;1;26074;1;0;26074;214;112;102;0;25860;18037;7823
120900;"myślenicki";"małopolskie";100;100;95502;98028;21527;73976;33;74009;131;1091;31;0;0;1;0;30;74001;30;3;73998;645;329;316;0;73353;51873;21480
121000;"nowosądecki";"małopolskie";195;195;159849;162544;37956;121892;67;121959;253;4657;66;3;0;0;0;63;121955;63;2;121953;873;433;440;0;121080;96486;24594
121100;"nowotarski";"małopolskie";156;156;142652;145501;46552;96099;38;96137;165;3110;38;4;0;0;0;34;96128;34;5;96123;701;286;415;0;95422;70292;25130
121200;"olkuski";"małopolskie";104;104;82201;82751;21852;60348;15;60363;122;867;14;0;0;0;0;14;60363;14;3;60360;527;304;223;0;59833;34405;25428
121300;"oświęcimski";"małopolskie";108;108;111744;113301;28959;82784;45;82829;209;1092;45;2;0;0;0;43;82823;43;2;82821;781;424;357;0;82040;44965;37075
121400;"proszowicki";"małopolskie";85;85;33115;33488;9951;23163;2;23165;59;255;2;0;0;0;0;2;23165;2;0;23165;195;82;113;0;22970;16694;6276
121500;"suski";"małopolskie";62;62;62785;63554;18116;44669;15;44684;128;954;15;0;0;0;0;15;44682;15;0;44682;363;185;178;0;44319;30850;13469
121600;"tarnowski";"małopolskie";194;194;151697;151342;46211;105484;86;105570;203;1402;85;4;0;0;0;81;105565;81;2;105563;826;377;449;0;104737;79391;25346
121700;"tatrzański";"małopolskie";54;54;51802;57104;11595;40203;24;40227;101;4564;24;3;0;0;0;21;40226;21;12;40214;291;154;137;0;39923;25592;14331
121800;"wadowicki";"małopolskie";116;116;118586;120777;31684;86901;25;86926;202;1105;25;0;0;0;0;25;86926;25;1;86925;758;389;369;0;86167;53806;32361
121900;"wielicki";"małopolskie";111;111;101706;105499;20732;80973;28;81001;106;1436;28;2;0;1;0;25;80997;25;16;80981;812;441;371;0;80169;44345;35824
126100;"Kraków";"małopolskie";456;456;604081;626893;104714;499325;531;499856;605;13464;518;31;5;1;3;481;499760;479;44;499716;5523;3099;2424;0;494193;187004;307189
126200;"Nowy Sącz";"małopolskie";53;53;60056;59029;16660;43395;42;43437;74;556;40;1;0;0;0;39;43429;39;1;43428;359;204;155;0;43069;26023;17046
126300;"Tarnów";"małopolskie";74;74;80003;79253;24328;55676;80;55756;154;1237;76;1;2;0;0;73;55747;73;0;55747;444;241;203;0;55303;28188;27115
140100;"białobrzeski";"mazowieckie";38;38;24961;25891;5653;19308;1;19309;42;319;1;0;0;0;0;1;19307;1;1;19306;171;75;96;0;19135;14382;4753
140200;"ciechanowski";"mazowieckie";71;71;65554;65876;19059;46494;21;46515;85;710;20;0;0;0;0;20;46513;20;1;46512;366;218;148;0;46146;29438;16708
140300;"garwoliński";"mazowieckie";147;147;81187;81661;18654;62537;10;62547;144;933;10;1;0;0;0;9;62548;9;0;62548;611;307;304;0;61937;46763;15174
140400;"gostyniński";"mazowieckie";53;53;33682;33583;10799;22883;4;22887;56;346;4;1;0;0;1;2;22885;2;0;22885;210;111;99;0;22675;14808;7867
140500;"grodziski";"mazowieckie";60;60;74279;78146;12090;62194;33;62227;92;1525;33;0;0;0;0;33;62226;33;3;62223;656;373;283;0;61567;27119;34448
140600;"grójecki";"mazowieckie";96;96;72942;76046;16483;56459;12;56471;124;1054;11;1;0;0;0;10;56468;10;0;56468;521;277;244;0;55947;35719;20228
140700;"kozienicki";"mazowieckie";67;67;45161;45816;11654;33505;12;33517;92;538;12;0;0;0;0;12;33517;12;1;33516;272;151;121;0;33244;22947;10297
140800;"legionowski";"mazowieckie";71;71;92574;97937;13725;78846;32;78878;126;2724;30;0;0;0;0;30;78871;30;7;78864;741;414;327;0;78123;33839;44284
140900;"lipski";"mazowieckie";45;45;25199;25502;8350;16859;1;16860;23;306;1;0;0;0;0;1;16860;1;1;16859;122;65;57;0;16737;12299;4438
141000;"łosicki";"mazowieckie";48;48;22818;22769;6815;16003;4;16007;33;326;4;0;0;0;0;4;16007;4;1;16006;128;62;66;0;15878;12411;3467
141100;"makowski";"mazowieckie";56;56;35037;33458;11523;23514;12;23526;62;515;12;0;0;0;0;12;23525;12;0;23525;197;98;99;0;23328;16975;6353
141200;"miński";"mazowieckie";126;126;115512;119731;23296;92215;59;92274;139;1618;58;3;0;0;0;55;92270;55;1;92269;881;461;420;0;91388;53428;37960
141300;"mławski";"mazowieckie";65;65;53026;53127;16991;36035;11;36046;87;536;10;0;0;0;0;10;36044;10;0;36044;249;103;146;0;35795;23981;11814
141400;"nowodworski";"mazowieckie";55;55;59037;61456;13642;45405;10;45415;65;1047;10;1;0;0;0;9;45411;9;2;45409;415;222;193;0;44994;24427;20567
141500;"ostrołęcki";"mazowieckie";118;118;71643;67494;25318;46327;4;46331;95;618;4;0;0;0;0;4;46330;4;0;46330;344;164;180;0;45986;35108;10878
141600;"ostrowski";"mazowieckie";94;94;56927;53901;18694;38235;6;38241;156;738;6;0;0;0;0;6;38240;6;0;38240;304;178;126;0;37936;27473;10463
141700;"otwocki";"mazowieckie";114;114;93343;96537;16232;77110;45;77155;157;1722;41;1;0;0;0;40;77148;40;11;77137;855;474;381;0;76282;40654;35628
141800;"piaseczyński";"mazowieckie";133;133;144314;152514;19327;124989;63;125052;196;4223;62;11;1;0;1;50;125029;50;10;125019;1148;612;536;0;123871;50740;73131
141900;"płocki";"mazowieckie";137;137;83740;84855;25815;57927;9;57936;130;681;9;0;0;0;0;9;57936;9;0;57936;519;250;269;0;57417;38999;18418
142000;"płoński";"mazowieckie";81;81;65373;66671;20460;44913;4;44917;83;840;3;0;0;0;0;3;44915;3;0;44915;369;191;178;0;44546;29450;15096
142100;"pruszkowski";"mazowieckie";94;94;124989;131440;17115;107877;60;107937;199;2964;55;3;0;0;0;52;107920;52;13;107907;1097;575;522;0;106810;43826;62984
142200;"przasnyski";"mazowieckie";64;64;38004;37931;12221;25783;3;25786;78;474;3;0;0;0;0;3;25784;3;0;25784;225;118;107;0;25559;18437;7122
142300;"przysuski";"mazowieckie";66;66;30993;31286;7521;23472;8;23480;124;472;8;0;0;0;0;8;23480;8;2;23478;180;90;90;0;23298;18467;4831
142400;"pułtuski";"mazowieckie";58;58;40987;39707;12989;27998;22;28020;77;510;21;2;0;0;0;19;28016;19;3;28013;232;132;100;0;27781;18643;9138
142500;"radomski";"mazowieckie";135;135;113228;114972;29660;83567;19;83586;130;959;19;0;0;0;0;19;83584;19;2;83582;674;344;330;0;82908;61762;21146
142600;"siedlecki";"mazowieckie";96;96;61170;61894;15198;45971;22;45993;50;606;20;1;0;0;0;19;45991;19;0;45991;376;189;187;0;45615;36876;8739
142700;"sierpecki";"mazowieckie";53;53;37827;37879;12674;25153;4;25157;73;317;4;0;0;0;0;4;25157;4;0;25157;184;107;77;0;24973;17353;7620
142800;"sochaczewski";"mazowieckie";67;67;61808;63403;15656;46152;12;46164;112;667;11;0;0;0;0;11;46163;11;2;46161;388;209;179;0;45773;27711;18062
142900;"sokołowski";"mazowieckie";55;55;40476;40080;11438;29037;7;29044;78;464;7;0;0;0;0;7;29044;7;1;29043;236;138;98;0;28807;21342;7465
143000;"szydłowiecki";"mazowieckie";36;36;29065;29485;8735;20331;6;20337;43;292;6;0;0;0;0;6;20334;6;1;20333;177;110;67;0;20156;15345;4811
143200;"warszawski zachodni";"mazowieckie";71;71;93257;97701;13706;79551;33;79584;106;2579;29;3;0;0;1;25;79567;25;2;79565;807;463;344;0;78758;34359;44399
143300;"węgrowski";"mazowieckie";72;72;49060;49871;12575;36484;27;36511;86;692;27;1;0;0;0;26;36508;26;1;36507;316;166;150;0;36191;25961;10230
143400;"wołomiński";"mazowieckie";170;170;187585;197624;31728;155857;63;155920;168;3043;61;1;0;0;0;60;155913;60;8;155905;1483;755;728;0;154422;86435;67987
143500;"wyszkowski";"mazowieckie";68;68;58756;57445;16303;42453;1;42454;102;818;1;0;0;0;0;1;42454;1;0;42454;358;159;199;0;42096;28813;13283
143600;"zwoleński";"mazowieckie";44;44;25914;27134;7058;18854;1;18855;35;272;1;0;0;0;0;1;18854;1;0;18854;144;78;66;0;18710;14259;4451
143700;"żuromiński";"mazowieckie";37;37;28423;28022;9817;18606;11;18617;39;195;10;0;0;0;0;10;18616;10;0;18616;128;62;66;0;18488;12386;6102
143800;"żyrardowski";"mazowieckie";64;64;54641;56905;12662;41980;15;41995;49;662;15;0;0;0;0;15;41992;15;2;41990;396;216;180;0;41594;22738;18856
146100;"Ostrołęka";"mazowieckie";29;29;38839;36125;13223;25616;19;25635;36;470;19;2;0;0;0;17;25633;17;0;25633;259;151;108;0;25374;14913;10461
146200;"Płock";"mazowieckie";71;71;84723;84383;23788;60935;34;60969;73;1495;34;1;0;0;0;33;60966;33;5;60961;510;291;219;0;60451;29023;31428
146300;"Radom";"mazowieckie";114;114;145065;145461;38156;106909;107;107016;120;1903;104;1;2;1;0;100;107000;99;11;106989;903;509;394;0;106086;58726;47360
146400;"Siedlce";"mazowieckie";43;43;55680;55697;13810;41869;29;41898;47;878;29;2;0;0;0;27;41896;27;2;41894;336;180;156;0;41558;24362;17196
146501;"Warszawa";"mazowieckie";851;851;1317272;1384869;166277;1151007;998;1152005;1547;39759;923;40;2;1;1;879;1151749;878;150;1151599;11924;6778;5146;0;1139675;362322;777353
;"statki";;5;5;280;204;104;176;0;176;0;48;0;0;0;0;0;0;176;0;0;176;4;3;1;0;172;67;105
;"zagranica";;511;511;877107;721608;268891;608215;0;608215;0;44521;0;0;0;0;0;0;608168;0;125;608043;3684;1463;2221;0;604359;220637;383722
160100;"brzeski";"opolskie";103;103;65153;65078;21501;43655;28;43683;75;722;28;0;0;0;1;27;43681;27;1;43680;345;171;174;0;43335;23221;20114
160200;"głubczycki";"opolskie";64;64;33792;33141;13076;20716;12;20728;62;398;12;0;0;0;0;12;20728;12;0;20728;175;87;88;0;20553;12276;8277
160300;"kędzierzyńsko-kozielski";"opolskie";71;71;65913;65554;26064;39830;22;39852;68;683;22;0;0;0;0;22;39849;22;0;39849;417;244;173;0;39432;16816;22616
160400;"kluczborski";"opolskie";70;70;47693;46880;18988;28708;11;28719;85;537;9;0;0;0;0;9;28719;9;3;28716;228;115;113;0;28488;14202;14286
160500;"krapkowicki";"opolskie";57;57;46060;46319;20299;25761;18;25779;29;481;17;1;0;0;0;16;25777;16;0;25777;242;119;123;0;25535;10581;14954
160600;"namysłowski";"opolskie";71;71;32345;31874;11313;21031;4;21035;51;338;4;0;0;0;0;4;21036;4;0;21036;170;90;80;0;20866;11356;9510
160700;"nyski";"opolskie";143;143;100855;99706;37090;63759;31;63790;129;1495;31;3;0;0;0;28;63786;28;1;63785;452;208;244;0;63333;34877;28456
160800;"oleski";"opolskie";69;69;47892;47848;19927;27963;4;27967;60;450;1;0;0;0;0;1;27965;1;0;27965;295;163;132;0;27670;14830;12840
160900;"opolski";"opolskie";135;135;93180;94447;38067;55113;15;55128;85;782;15;1;0;0;0;14;55128;14;0;55128;557;296;261;0;54571;22561;32010
161000;"prudnicki";"opolskie";75;75;40117;39630;16753;23364;7;23371;64;305;6;0;0;0;0;6;23370;6;0;23370;180;107;73;0;23190;12761;10429
161100;"strzelecki";"opolskie";81;81;56327;56120;24442;31885;7;31892;54;321;7;0;0;0;0;7;31892;7;0;31892;324;163;161;0;31568;14756;16812
166100;"Opole";"opolskie";84;84;91691;94245;22353;69331;62;69393;98;1662;59;8;1;0;0;50;69388;50;4;69384;612;314;298;0;68772;22084;46688
180100;"bieszczadzki";"podkarpackie";37;37;16491;16354;6180;10311;1;10312;26;379;1;0;0;0;0;1;10312;1;0;10312;88;44;44;0;10224;6343;3881
180200;"brzozowski";"podkarpackie";59;59;49125;48709;15946;33179;14;33193;135;392;14;1;0;0;0;13;33191;13;1;33190;193;95;98;0;32997;26955;6042
180300;"dębicki";"podkarpackie";118;118;100990;100881;29166;71824;31;71855;197;799;29;0;0;0;0;29;71852;29;0;71852;511;271;240;0;71341;53337;18004
180400;"jarosławski";"podkarpackie";120;120;89801;88973;29430;60369;28;60397;172;904;28;1;0;0;0;27;60394;27;1;60393;415;207;208;0;59978;45198;14780
180500;"jasielski";"podkarpackie";127;127;85842;84749;27575;58266;19;58285;163;583;19;1;0;0;0;18;58284;18;0;58284;456;234;222;0;57828;43409;14419
180600;"kolbuszowski";"podkarpackie";66;66;47547;46563;16592;30955;5;30960;92;278;5;1;0;0;0;4;30958;4;0;30958;230;117;113;0;30728;24763;5965
180700;"krośnieński";"podkarpackie";110;110;86540;85925;27341;59199;48;59247;168;2024;47;2;0;0;0;45;59241;45;1;59240;405;190;215;0;58835;43647;15188
180800;"leżajski";"podkarpackie";58;58;51649;50613;17044;34604;5;34609;77;453;5;0;0;0;0;5;34608;5;0;34608;237;122;115;0;34371;27811;6560
180900;"lubaczowski";"podkarpackie";67;67;41665;41147;15227;26437;1;26438;70;665;1;0;0;0;0;1;26439;1;0;26439;186;95;91;0;26253;19205;7048
181000;"łańcucki";"podkarpackie";58;58;60978;61610;16300;44678;24;44702;94;535;24;0;0;0;0;24;44698;24;0;44698;334;175;159;0;44364;33828;10536
181100;"mielecki";"podkarpackie";124;124;100836;100890;30107;70729;33;70762;166;733;33;2;0;0;0;31;70755;29;0;70755;557;267;290;0;70198;50197;20001
181200;"niżański";"podkarpackie";83;83;50324;49155;18376;31948;7;31955;110;472;7;0;0;0;0;7;31952;7;0;31952;219;108;111;0;31733;24828;6905
181300;"przemyski";"podkarpackie";106;106;55917;55396;19091;36825;14;36839;96;667;13;0;0;0;0;13;36838;13;7;36831;230;112;118;0;36601;27865;8736
181400;"przeworski";"podkarpackie";82;82;59208;59091;18529;40678;14;40692;159;367;14;1;0;0;0;13;40691;13;3;40688;280;135;145;0;40408;31115;9293
181500;"ropczycko-sędziszowski";"podkarpackie";69;69;55997;56277;15704;40292;14;40306;137;377;14;2;0;0;0;12;40304;12;1;40303;308;149;159;0;39995;32461;7534
181600;"rzeszowski";"podkarpackie";127;127;128950;131469;32186;96767;28;96795;196;1082;28;0;0;0;0;28;96788;28;0;96788;762;397;365;0;96026;72152;23874
181700;"sanocki";"podkarpackie";82;82;69802;68824;24867;44937;21;44958;118;839;21;0;0;0;0;21;44955;21;2;44953;338;173;165;0;44615;29691;14924
181800;"stalowowolski";"podkarpackie";95;95;77983;76245;27025;50959;34;50993;101;685;33;3;0;0;0;30;50986;30;0;50986;377;191;186;0;50609;34547;16062
181900;"strzyżowski";"podkarpackie";65;65;46136;46183;14954;31182;9;31191;69;426;9;1;0;0;0;8;31190;8;2;31188;250;124;126;0;30938;24296;6642
182000;"tarnobrzeski";"podkarpackie";51;51;40165;40390;13457;26708;11;26719;60;552;11;0;0;0;0;11;26718;11;1;26717;197;82;115;0;26520;19607;6913
182100;"leski";"podkarpackie";33;33;22364;22413;6916;15448;4;15452;52;1578;4;0;0;0;0;4;15451;4;1;15450;121;66;55;0;15329;9881;5448
186100;"Krosno";"podkarpackie";28;28;34103;33510;10530;23573;9;23582;71;628;9;0;0;0;0;9;23582;9;1;23581;172;92;80;0;23409;13011;10398
186200;"Przemyśl";"podkarpackie";39;39;43587;42276;15518;28068;47;28115;81;804;45;1;1;0;0;43;28109;43;4;28105;222;127;95;0;27883;15150;12733
186300;"Rzeszów";"podkarpackie";102;102;145134;153251;28854;116278;93;116371;149;2308;90;5;0;0;0;85;116358;85;6;116352;1129;683;446;0;115223;59527;55696
186400;"Tarnobrzeg";"podkarpackie";35;35;34209;33178;11551;22658;15;22673;64;445;14;0;0;0;0;14;22671;14;0;22671;163;87;76;0;22508;11605;10903
200100;"augustowski";"podlaskie";54;54;43084;43089;15438;27646;10;27656;69;1023;10;0;0;0;0;10;27655;10;3;27652;212;100;112;0;27440;17712;9728
200200;"białostocki";"podlaskie";149;149;119261;120069;33997;85260;41;85301;174;1630;41;2;0;0;0;39;85296;39;6;85290;746;402;344;0;84544;51709;32835
200300;"bielski";"podlaskie";56;56;40737;39979;14767;25969;9;25978;127;478;9;0;0;0;0;9;25978;9;0;25978;185;95;90;0;25793;15488;10305
200400;"grajewski";"podlaskie";46;46;34036;33626;13318;20718;8;20726;40;393;8;1;0;0;0;7;20725;7;1;20724;168;77;91;0;20556;14666;5890
200500;"hajnowski";"podlaskie";47;47;35034;33600;14345;20688;14;20702;38;1121;14;0;0;0;0;14;20700;14;1;20699;228;133;95;0;20471;9043;11428
200600;"kolneński";"podlaskie";48;48;28326;27894;10749;17577;9;17586;55;240;9;1;0;0;0;8;17584;8;0;17584;106;38;68;0;17478;13812;3666
200700;"łomżyński";"podlaskie";61;61;38315;38479;12650;25665;4;25669;85;283;4;1;0;0;0;3;25666;3;0;25666;183;65;118;0;25483;20474;5009
200800;"moniecki";"podlaskie";43;43;29723;29461;12054;17669;8;17677;55;313;8;0;0;0;0;8;17677;8;1;17676;143;75;68;0;17533;13003;4530
200900;"sejneński";"podlaskie";22;22;14890;15060;5942;8948;2;8950;43;387;2;0;0;0;0;2;8950;2;0;8950;79;34;45;0;8871;4891;3980
201000;"siemiatycki";"podlaskie";54;54;33485;32259;13332;20153;4;20157;56;715;4;0;0;0;0;4;20156;4;1;20155;181;89;92;0;19974;12819;7155
201100;"sokólski";"podlaskie";73;73;49757;48778;19411;30346;5;30351;114;659;4;0;0;0;0;4;30351;4;0;30351;258;139;119;0;30093;20654;9439
201200;"suwalski";"podlaskie";42;42;26721;27065;9128;17583;5;17588;62;485;5;2;0;0;0;3;17586;3;2;17584;131;64;67;0;17453;12050;5403
201300;"wysokomazowiecki";"podlaskie";68;68;42132;41550;12559;29573;4;29577;119;461;4;0;0;0;0;4;29577;4;0;29577;225;127;98;0;29352;24000;5352
201400;"zambrowski";"podlaskie";49;49;33105;32249;11320;21785;3;21788;45;246;2;0;0;0;0;2;21787;2;2;21785;156;70;86;0;21629;15757;5872
206100;"Białystok";"podlaskie";192;192;204420;212573;48703;155725;121;155846;211;3009;117;6;3;0;1;107;155824;107;13;155811;1593;878;715;0;154218;75562;78656
206200;"Łomża";"podlaskie";32;32;43534;42821;14000;29534;32;29566;66;631;32;1;0;0;0;31;29565;31;0;29565;232;136;96;0;29333;18087;11246
206300;"Suwałki";"podlaskie";38;38;50673;49073;17715;32963;17;32980;58;787;17;0;0;0;0;17;32977;17;1;32976;288;155;133;0;32688;18120;14568
220100;"bytowski";"pomorskie";114;114;56622;56958;19625;36997;21;37018;60;711;21;2;0;0;0;19;37015;18;3;37012;353;160;193;0;36659;19144;17515
220200;"chojnicki";"pomorskie";86;86;70150;70545;21744;48404;20;48424;97;1148;19;7;0;0;0;12;48413;12;1;48412;410;206;204;0;48002;26085;21917
220300;"człuchowski";"pomorskie";78;78;41606;40888;16357;25250;10;25260;43;624;10;0;0;0;0;10;25260;10;1;25259;230;106;124;0;25029;11612;13417
220400;"gdański";"pomorskie";76;76;89247;94195;19594;69648;21;69669;119;1804;19;1;0;0;0;18;69668;18;3;69665;723;375;348;0;68942;26314;42628
220500;"kartuski";"pomorskie";112;112;102548;108397;21368;81192;32;81224;70;1677;32;5;1;0;0;26;81218;26;6;81212;768;407;361;0;80444;43362;37082
220600;"kościerski";"pomorskie";63;63;52821;54500;14247;38573;34;38607;63;1147;32;1;0;0;1;30;38604;30;4;38600;344;192;152;0;38256;21053;17203
220700;"kwidzyński";"pomorskie";77;77;59250;58523;21985;37265;14;37279;62;538;13;0;0;0;0;13;37277;13;2;37275;353;163;190;0;36922;18059;18863
220800;"lęborski";"pomorskie";60;60;47983;48354;14360;33620;15;33635;56;1967;15;3;0;0;0;12;33635;12;0;33635;278;134;144;0;33357;14661;18696
220900;"malborski";"pomorskie";44;44;45178;44937;15894;29286;13;29299;62;501;13;0;1;0;0;12;29294;12;1;29293;217;123;94;0;29076;12310;16766
221000;"nowodworski";"pomorskie";39;39;30667;30069;9985;20682;4;20686;33;2938;4;0;0;0;0;4;20682;4;4;20678;157;89;68;0;20521;8524;11997
221100;"pucki";"pomorskie";77;77;76105;78070;16565;59543;11;59554;62;6523;10;3;0;0;0;8;59545;8;1;59544;587;306;281;0;58957;24655;34302
221200;"słupski";"pomorskie";128;128;73799;73714;24916;48882;31;48913;92;4007;27;1;0;0;0;26;48907;26;1;48906;418;206;212;0;48488;21174;27314
221300;"starogardzki";"pomorskie";112;112;91295;92564;29418;61885;30;61915;100;1295;28;5;0;0;0;23;61911;23;4;61907;519;266;253;0;61388;33992;27396
221400;"tczewski";"pomorskie";100;100;80598;81602;26121;54476;18;54494;85;856;18;3;0;0;0;15;54488;15;4;54484;532;275;257;0;53952;26042;27910
221500;"wejherowski";"pomorskie";131;131;156703;164321;36356;120349;54;120403;202;2354;53;5;0;0;0;48;120389;48;9;120380;1215;632;583;0;119165;53626;65539
221600;"sztumski";"pomorskie";44;44;30065;29769;12436;17629;2;17631;43;264;2;0;0;0;0;2;17630;2;3;17627;204;104;100;0;17423;8297;9126
226100;"Gdańsk";"pomorskie";205;205;347213;376703;49980;297247;275;297522;313;9668;261;9;2;2;0;248;297471;248;57;297414;3082;1703;1379;0;294332;88205;206127
226200;"Gdynia";"pomorskie";118;118;172357;180890;31329;141025;150;141175;319;4533;144;16;1;4;0;123;141144;122;13;141131;1408;784;624;0;139723;41994;97729
226300;"Słupsk";"pomorskie";47;47;61657;61774;18440;43216;53;43269;92;1249;53;2;1;0;0;50;43266;50;2;43264;389;215;174;0;42875;16285;26590
226400;"Sopot";"pomorskie";25;25;26049;29030;3793;23254;18;23272;88;2207;18;1;0;0;0;17;23268;17;5;23263;226;112;114;0;23037;6331;16706
240100;"będziński";"śląskie";100;100;109255;110588;30219;79035;49;79084;198;1609;44;5;1;0;0;38;79068;38;4;79064;765;463;302;0;78299;31364;46935
240200;"bielski";"śląskie";94;94;122012;125484;28225;93756;60;93816;249;1714;60;5;0;0;0;55;93806;55;5;93801;903;515;388;0;92898;48269;44629
240300;"cieszyński";"śląskie";127;127;132092;135754;35301;96793;90;96883;224;4609;89;2;0;1;1;86;96872;86;1;96871;919;503;416;0;95952;47359;48593
240400;"częstochowski";"śląskie";145;145;103529;104116;29921;73607;24;73631;125;860;22;1;0;0;0;21;73627;21;0;73627;685;370;315;0;72942;42073;30869
240500;"gliwicki";"śląskie";89;89;83744;84932;25882;57858;30;57888;60;867;30;7;0;1;2;20;57881;20;6;57875;594;334;260;0;57281;29360;27921
240600;"kłobucki";"śląskie";73;73;64473;65009;19557;44900;20;44920;80;580;17;0;0;0;0;17;44929;17;0;44929;424;238;186;0;44505;25704;18801
240700;"lubliniecki";"śląskie";72;72;58231;58879;20116;38117;33;38150;73;626;33;0;0;0;0;33;38148;33;1;38147;402;200;202;0;37745;21474;16271
240800;"mikołowski";"śląskie";65;65;72242;73879;17685;54558;37;54595;143;716;36;3;0;0;0;33;54587;33;11;54576;551;312;239;0;54025;26417;27608
240900;"myszkowski";"śląskie";61;61;53330;53688;16244;37086;8;37094;125;665;8;0;0;0;0;8;37093;8;2;37091;354;223;131;0;36737;20911;15826
241000;"pszczyński";"śląskie";84;84;80861;82342;19059;61811;68;61879;105;802;67;6;0;0;0;61;61870;61;3;61867;607;342;265;0;61260;37285;23975
241100;"raciborski";"śląskie";85;85;76401;77066;30042;46358;22;46380;75;547;22;0;0;0;0;22;46380;22;8;46372;438;239;199;0;45934;23414;22520
241200;"rybnicki";"śląskie";48;48;56112;57468;15361;40751;5;40756;76;457;5;0;0;0;0;5;40756;5;0;40756;417;221;196;0;40339;25097;15242
241300;"tarnogórski";"śląskie";92;92;104834;106282;30669;74165;71;74236;181;1028;70;3;0;0;0;67;74218;67;12;74206;730;415;315;0;73476;34803;38673
241400;"bieruńsko-lędziński";"śląskie";42;42;43524;44220;11059;32465;44;32509;56;436;41;0;0;0;0;41;32505;41;0;32505;338;201;137;0;32167;20002;12165
241500;"wodzisławski";"śląskie";103;103;112048;113868;33086;78963;37;79000;197;1380;37;0;0;0;1;36;78995;36;2;78993;694;393;301;0;78299;46594;31705
241600;"zawierciański";"śląskie";121;121;88658;88963;26338;62320;26;62346;148;1173;24;2;0;0;0;22;62341;22;0;62341;541;293;248;0;61800;34241;27559
241700;"żywiecki";"śląskie";107;107;112885;115466;30055;82830;87;82917;284;1983;87;0;0;0;0;87;82906;87;1;82905;662;319;343;0;82243;53045;29198
246100;"Bielsko-Biała";"śląskie";77;77;119681;122604;28790;90878;125;91003;201;2290;116;1;2;0;0;113;90981;107;2;90979;799;464;335;0;90180;39739;50441
246200;"Bytom";"śląskie";82;82;104614;105446;36221;68393;84;68477;76;819;80;6;0;0;1;73;68463;73;9;68454;701;354;347;0;67753;30333;37420
246300;"Chorzów";"śląskie";65;65;71266;71815;22854;48429;33;48462;104;547;30;2;2;0;0;26;48452;26;10;48442;473;252;221;0;47969;18692;29277
246400;"Częstochowa";"śląskie";135;135;154835;155709;41583;113261;155;113416;186;2575;152;9;1;0;0;142;113388;142;4;113384;995;567;428;0;112389;48989;63400
246500;"Dąbrowa Górnicza";"śląskie";67;67;84973;85807;23392;61579;37;61616;84;1380;34;3;1;0;0;30;61608;30;4;61604;588;338;250;0;61016;24280;36736
246600;"Gliwice";"śląskie";117;117;124825;125968;32153;92674;99;92773;191;1604;96;0;1;0;0;95;92768;95;7;92761;899;506;393;0;91862;35889;55973
246700;"Jastrzębie-Zdrój";"śląskie";38;38;62300;61854;19075;43225;24;43249;62;672;24;1;1;0;0;22;43247;22;2;43245;354;184;170;0;42891;25700;17191
246800;"Jaworzno";"śląskie";48;48;64932;65534;18533;46396;55;46451;137;917;55;2;0;0;0;53;46452;53;1;46451;411;231;180;0;46040;21645;24395
246900;"Katowice";"śląskie";168;168;207644;213416;48225;159433;184;159617;260;3439;177;13;1;0;1;162;159576;161;15;159561;1582;910;672;0;157979;58219;99760
247000;"Mysłowice";"śląskie";41;41;51773;52249;13952;37822;25;37847;86;726;25;1;0;0;0;24;37846;24;0;37846;328;177;151;0;37518;18231;19287
247100;"Piekary Śląskie";"śląskie";32;32;38642;38939;11848;26794;25;26819;56;358;25;1;0;0;0;24;26818;24;0;26818;281;130;151;0;26537;13450;13087
247200;"Ruda Śląska";"śląskie";79;79;95224;96198;29871;65350;52;65402;107;728;51;0;0;0;0;51;65401;51;1;65400;655;349;306;0;64745;32071;32674
247300;"Rybnik";"śląskie";72;72;95659;97079;27394;68263;57;68320;111;1140;56;13;0;0;2;41;68303;41;1;68302;596;337;259;0;67706;35389;32317
247400;"Siemianowice Śląskie";"śląskie";41;41;45960;46831;13231;32729;17;32746;69;650;17;1;0;0;0;16;32745;16;1;32744;351;206;145;0;32393;12950;19443
247500;"Sosnowiec";"śląskie";107;107;140505;141536;38934;101568;68;101636;176;2095;67;4;0;0;0;63;101627;63;0;101627;922;525;397;0;100705;39928;60777
247600;"Świętochłowice";"śląskie";27;27;33110;33473;11455;21655;7;21662;34;283;6;0;0;0;0;6;21661;6;1;21660;202;103;99;0;21458;9676;11782
247700;"Tychy";"śląskie";67;67;88464;89027;22294;66180;68;66248;140;1323;64;0;0;0;0;64;66243;64;4;66239;638;375;263;0;65601;29861;35740
247800;"Zabrze";"śląskie";89;89;114011;114921;42271;71751;57;71808;128;1178;54;0;0;0;0;54;71803;54;0;71803;755;409;346;0;71048;31920;39128
247900;"Żory";"śląskie";26;26;44185;45126;12065;32120;11;32131;50;459;11;1;0;0;0;10;32128;10;0;32128;272;147;125;0;31856;16831;15025
260100;"buski";"świętokrzyskie";94;94;56518;56704;17826;38692;5;38697;115;2498;5;1;0;0;0;4;38696;4;0;38696;295;146;149;0;38401;25395;13006
260200;"jędrzejowski";"świętokrzyskie";97;97;63804;64472;19324;44480;11;44491;88;617;11;1;0;0;0;10;44488;10;1;44487;274;159;115;0;44213;31483;12730
260300;"kazimierski";"świętokrzyskie";34;34;25659;25793;9604;16055;4;16059;68;189;4;0;0;0;0;4;16060;4;4;16056;108;61;47;0;15948;11196;4752
260400;"kielecki";"świętokrzyskie";249;249;161981;163922;44765;117217;31;117248;190;1598;28;3;0;0;0;25;117239;25;3;117236;897;477;420;0;116339;82526;33813
260500;"konecki";"świętokrzyskie";89;89;60387;59949;18884;41503;7;41510;139;616;7;0;0;0;0;7;41509;7;3;41506;331;183;148;0;41175;27324;13851
260600;"opatowski";"świętokrzyskie";85;85;39861;38910;14568;25292;5;25297;68;399;5;0;0;0;0;5;25296;5;0;25296;239;124;115;0;25057;18704;6353
260700;"ostrowiecki";"świętokrzyskie";96;96;79349;77392;29066;50273;35;50308;100;678;35;1;0;0;0;34;50303;34;3;50300;421;231;190;0;49879;28540;21339
260800;"pińczowski";"świętokrzyskie";41;41;30281;30284;10416;19865;8;19873;79;323;8;0;0;0;0;8;19872;8;1;19871;126;58;68;0;19745;13237;6508
260900;"sandomierski";"świętokrzyskie";93;93;58186;57502;19916;38270;22;38292;154;711;21;0;0;0;0;21;38290;21;0;38290;290;150;140;0;38000;25026;12974
261000;"skarżyski";"świętokrzyskie";67;67;54440;53244;18173;36267;26;36293;152;584;25;0;0;0;0;25;36289;25;4;36285;351;210;141;0;35934;19822;16112
261100;"starachowicki";"świętokrzyskie";70;70;65825;65086;21929;43896;24;43920;98;702;24;0;0;0;0;24;43918;24;12;43906;341;184;157;0;43565;26892;16673
261200;"staszowski";"świętokrzyskie";92;92;54793;53937;18067;36736;8;36744;63;484;7;0;0;0;0;7;36743;7;1;36742;253;138;115;0;36489;26541;9948
261300;"włoszczowski";"świętokrzyskie";42;42;34527;34511;10457;24070;7;24077;52;369;7;1;0;0;0;6;24076;6;0;24076;182;96;86;0;23894;17441;6453
266100;"Kielce";"świętokrzyskie";95;95;139227;139565;35246;103991;114;104105;180;2136;110;5;1;0;1;103;104084;101;17;104067;948;575;373;0;103119;47736;55383
280100;"bartoszycki";"warmińsko-mazurskie";58;58;42296;41063;17600;24696;10;24706;50;543;10;0;0;0;0;10;24705;10;2;24703;199;81;118;0;24504;12109;12395
280200;"braniewski";"warmińsko-mazurskie";42;42;29206;28710;12058;17148;8;17156;62;482;8;0;0;0;0;8;17156;8;0;17156;141;77;64;0;17015;8554;8461
280300;"działdowski";"warmińsko-mazurskie";78;78;47468;47285;17304;30164;10;30174;53;465;9;0;0;0;0;9;30172;9;0;30172;263;115;148;0;29909;17820;12089
280400;"elbląski";"warmińsko-mazurskie";58;58;41428;41715;15946;25482;11;25493;51;572;10;2;0;0;0;8;25489;8;2;25487;234;118;116;0;25253;12686;12567
280500;"ełcki";"warmińsko-mazurskie";58;58;63962;63760;25748;38216;9;38225;60;897;6;0;0;0;0;6;38221;6;1;38220;298;132;166;0;37922;20497;17425
280600;"giżycki";"warmińsko-mazurskie";57;57;41512;42784;13558;27955;12;27967;32;1997;12;0;0;0;0;12;27968;12;2;27966;256;138;118;0;27710;12104;15606
280700;"iławski";"warmińsko-mazurskie";74;74;67785;68234;22835;44950;18;44968;73;1021;17;1;0;0;0;16;44966;16;1;44965;355;184;171;0;44610;23989;20621
280800;"kętrzyński";"warmińsko-mazurskie";59;59;44545;43993;18633;25910;16;25926;54;581;16;0;0;0;0;16;25926;16;3;25923;205;109;96;0;25718;12644;13074
280900;"lidzbarski";"warmińsko-mazurskie";41;41;28928;28974;11281;17647;5;17652;48;481;5;0;0;0;0;5;17651;5;4;17647;158;71;87;0;17489;8544;8945
281000;"mrągowski";"warmińsko-mazurskie";49;49;36555;37327;12658;23897;5;23902;47;1408;5;0;0;0;0;5;23900;5;3;23897;202;112;90;0;23695;11259;12436
281100;"nidzicki";"warmińsko-mazurskie";38;38;23622;23750;8673;14949;6;14955;20;256;6;0;0;0;0;6;14954;6;2;14952;138;68;70;0;14814;8898;5916
281200;"nowomiejski";"warmińsko-mazurskie";59;59;31367;31826;10934;20433;0;20433;67;349;0;0;0;0;0;0;20432;0;0;20432;170;87;83;0;20262;12545;7717
281300;"olecki";"warmińsko-mazurskie";36;36;23934;23700;10156;13778;3;13781;42;298;3;1;0;0;0;2;13780;2;0;13780;98;49;49;0;13682;7824;5858
281400;"olsztyński";"warmińsko-mazurskie";160;160;97236;99163;31449;65788;46;65834;101;1761;46;0;3;0;0;43;65830;43;5;65825;632;289;343;0;65193;28893;36300
281500;"ostródzki";"warmińsko-mazurskie";101;101;74210;75545;26683;47527;18;47545;96;1317;18;0;0;0;0;18;47543;18;1;47542;371;182;189;0;47171;22083;25088
281600;"piski";"warmińsko-mazurskie";51;51;40274;41385;14871;25403;3;25406;60;1275;3;0;0;0;0;3;25406;3;5;25401;203;88;115;0;25198;15091;10107
281700;"szczycieński";"warmińsko-mazurskie";84;84;51286;52795;17483;33803;3;33806;90;1227;3;0;0;0;0;3;33804;3;0;33804;287;121;166;0;33517;18280;15237
281800;"gołdapski";"warmińsko-mazurskie";25;25;18983;18712;8142;10841;15;10856;18;432;15;0;0;0;0;15;10856;15;0;10856;61;22;39;0;10795;5524;5271
281900;"węgorzewski";"warmińsko-mazurskie";29;29;16585;16667;6283;10302;6;10308;21;458;6;0;0;0;0;6;10308;6;0;10308;68;27;41;0;10240;4732;5508
286100;"Elbląg";"warmińsko-mazurskie";62;62;82138;81831;25692;56446;53;56499;89;1200;49;5;0;0;2;42;56479;42;3;56476;530;288;242;0;55946;22593;33353
286200;"Olsztyn";"warmińsko-mazurskie";104;104;120762;126177;26268;94490;70;94560;159;2394;68;7;0;0;0;61;94549;61;23;94526;889;498;391;0;93637;34128;59509
300100;"chodzieski";"wielkopolskie";47;47;34352;34493;11110;23239;3;23242;52;447;3;0;0;0;0;3;23245;3;1;23244;235;147;88;0;23009;9439;13570
300200;"czarnkowsko-trzcianecki";"wielkopolskie";84;84;62722;63012;21124;41595;20;41615;68;748;20;0;0;0;0;20;41616;20;2;41614;361;198;163;0;41253;19153;22100
300300;"gnieźnieński";"wielkopolskie";128;128;105324;107295;30430;74900;47;74947;133;1005;47;1;0;0;0;46;74943;46;12;74931;713;433;280;0;74218;35025;39193
300400;"gostyński";"wielkopolskie";91;91;54921;55864;17891;37030;7;37037;62;258;6;0;0;0;0;6;37035;6;1;37034;328;185;143;0;36706;22162;14544
300500;"grodziski";"wielkopolskie";32;32;37655;38452;11848;25807;5;25812;47;239;5;0;0;0;0;5;25810;5;0;25810;231;124;107;0;25579;13753;11826
300600;"jarociński";"wielkopolskie";64;64;52183;52724;16071;36112;12;36124;53;435;12;2;0;0;0;10;36119;10;1;36118;394;250;144;0;35724;20059;15665
300700;"kaliski";"wielkopolskie";99;99;62803;63685;18802;43998;15;44013;82;419;13;1;0;0;0;12;44011;12;1;44010;363;202;161;0;43647;29125;14522
300800;"kępiński";"wielkopolskie";54;54;41764;42207;12503;29261;4;29265;52;334;4;0;0;0;0;4;29264;4;2;29262;266;154;112;0;28996;15527;13469
300900;"kolski";"wielkopolskie";68;68;63364;63430;20659;42705;5;42710;101;471;5;3;0;0;0;2;42705;2;4;42701;329;178;151;0;42372;28599;13773
301000;"koniński";"wielkopolskie";121;121;98238;99705;29638;68599;5;68604;161;958;5;1;0;0;0;4;68604;4;2;68602;565;316;249;0;68037;46299;21738
301100;"kościański";"wielkopolskie";82;82;57798;58964;16842;40956;28;40984;57;522;27;0;0;0;0;27;40981;27;5;40976;404;226;178;0;40572;20033;20539
301200;"krotoszyński";"wielkopolskie";74;74;55899;56413;17924;37975;13;37988;67;441;12;0;0;0;1;11;37983;11;2;37981;368;189;179;0;37613;21410;16203
301300;"leszczyński";"wielkopolskie";51;51;43962;45492;12665;31297;4;31301;31;609;4;0;0;0;0;4;31300;4;5;31295;336;185;151;0;30959;16244;14715
301400;"międzychodzki";"wielkopolskie";27;27;27201;27682;9308;17891;3;17894;45;441;3;0;0;0;0;3;17896;3;0;17896;193;101;92;0;17703;7727;9976
301500;"nowotomyski";"wielkopolskie";56;56;55278;56393;16178;39099;5;39104;50;624;5;0;0;0;0;5;39102;5;6;39096;406;239;167;0;38690;16954;21736
301600;"obornicki";"wielkopolskie";69;69;42679;43423;12895;29784;3;29787;53;542;3;0;0;0;0;3;29786;3;0;29786;280;173;107;0;29506;12541;16965
301700;"ostrowski";"wielkopolskie";148;148;119267;120186;34914;84352;59;84411;157;1387;56;0;0;0;0;56;84406;55;0;84406;737;440;297;0;83669;43262;40407
301800;"ostrzeszowski";"wielkopolskie";71;71;41467;41707;13026;28441;8;28449;42;363;8;0;0;0;0;8;28448;8;2;28446;262;157;105;0;28184;15821;12363
301900;"pilski";"wielkopolskie";124;124;96352;96456;30491;65859;40;65899;119;1560;39;1;0;0;0;38;65897;38;2;65895;549;311;238;0;65346;28961;36385
302000;"pleszewski";"wielkopolskie";72;72;46975;47131;15108;31866;11;31877;56;428;11;0;0;0;0;11;31876;11;3;31873;314;188;126;0;31559;18046;13513
302100;"poznański";"wielkopolskie";252;252;311563;323518;55555;255986;61;256047;378;4698;58;3;0;0;0;55;256030;55;20;256010;2541;1465;1076;0;253469;82399;171070
302200;"rawicki";"wielkopolskie";65;65;44303;45058;14776;29527;14;29541;24;364;13;0;1;0;0;12;29538;12;0;29538;314;183;131;0;29224;15307;13917
302300;"słupecki";"wielkopolskie";65;65;44121;44818;13961;30160;6;30166;56;562;6;0;0;0;0;6;30165;6;0;30165;270;159;111;0;29895;17516;12379
302400;"szamotulski";"wielkopolskie";61;61;68495;70457;19113;49382;9;49391;106;725;8;1;0;0;0;7;49384;7;1;49383;488;281;207;0;48895;20412;28483
302500;"średzki";"wielkopolskie";55;55;43608;45138;11987;31622;6;31628;38;439;6;1;0;0;0;5;31625;5;8;31617;353;176;177;0;31264;15137;16127
302600;"śremski";"wielkopolskie";47;47;44680;45738;13382;31298;8;31306;45;453;8;0;0;0;0;8;31304;8;0;31304;305;169;136;0;30999;14961;16038
302700;"turecki";"wielkopolskie";74;74;61692;62206;18427;43264;13;43277;80;568;12;1;0;0;0;11;43276;11;0;43276;346;191;155;0;42930;28121;14809
302800;"wągrowiecki";"wielkopolskie";79;79;50768;51793;15967;34802;5;34807;51;461;5;1;0;0;0;4;34804;4;0;34804;307;181;126;0;34497;16429;18068
302900;"wolsztyński";"wielkopolskie";50;50;42135;42969;12538;29597;4;29601;27;554;4;0;0;0;0;4;29600;4;0;29600;304;172;132;0;29296;14742;14554
303000;"wrzesiński";"wielkopolskie";73;73;56919;58297;15731;41192;21;41213;63;498;21;0;0;0;0;21;41212;21;1;41211;397;213;184;0;40814;20746;20068
303100;"złotowski";"wielkopolskie";72;72;49925;50017;18635;31289;17;31306;47;493;16;0;0;0;0;16;31307;16;0;31307;255;121;134;0;31052;14556;16496
306100;"Kalisz";"wielkopolskie";57;57;70099;69761;19633;50466;84;50550;61;614;82;6;1;1;0;74;50536;74;3;50533;424;263;161;0;50109;20275;29834
306200;"Konin";"wielkopolskie";47;47;51649;51322;14963;36686;52;36738;25;748;51;2;0;0;0;49;36734;49;2;36732;326;181;145;0;36406;17255;19151
306300;"Leszno";"wielkopolskie";34;34;43599;44057;11760;31839;59;31898;66;627;56;8;0;1;0;47;31885;47;2;31883;284;167;117;0;31599;10908;20691
306400;"Poznań";"wielkopolskie";259;259;388717;413189;61931;326832;300;327132;396;7891;279;24;3;0;0;252;327063;252;41;327022;3509;1968;1541;0;323513;88225;235288
320100;"białogardzki";"zachodniopomorskie";36;36;33506;33225;13090;20416;4;20420;58;289;4;0;0;0;0;4;20418;4;1;20417;181;104;77;0;20236;9407;10829
320200;"choszczeński";"zachodniopomorskie";63;63;34482;34277;13316;21167;4;21171;58;547;4;0;0;0;0;4;21169;4;1;21168;183;91;92;0;20985;10392;10593
320300;"drawski";"zachodniopomorskie";63;63;41269;41113;15972;25296;12;25308;62;546;12;2;0;0;1;9;25306;9;0;25306;220;98;122;0;25086;11601;13485
320400;"goleniowski";"zachodniopomorskie";76;76;61019;61537;20549;40470;18;40488;86;606;17;0;1;0;1;15;40484;15;3;40481;390;169;221;0;40091;17857;22234
320500;"gryficki";"zachodniopomorskie";59;59;50489;49551;17156;33336;7;33343;80;3868;7;0;0;0;0;7;33321;7;9;33312;285;132;153;0;33027;14223;18804
320600;"gryfiński";"zachodniopomorskie";85;85;58573;59161;20621;37951;24;37975;75;882;23;6;0;0;1;18;37971;18;0;37971;334;163;171;0;37637;18970;18667
320700;"kamieński";"zachodniopomorskie";52;52;38856;39847;11670;27183;8;27191;46;4162;8;0;0;0;0;8;27189;8;6;27183;189;98;91;0;26994;11162;15832
320800;"kołobrzeski";"zachodniopomorskie";66;66;69485;71349;16594;52891;18;52909;82;11904;17;0;1;0;0;16;52907;16;7;52900;387;183;204;0;52513;20739;31774
320900;"koszaliński";"zachodniopomorskie";77;77;53284;54099;16393;36892;8;36900;58;4584;8;2;0;0;1;5;36896;5;1;36895;322;149;173;0;36573;15977;20596
321000;"myśliborski";"zachodniopomorskie";74;74;46702;46506;17601;29101;3;29104;70;520;3;0;0;0;0;3;29103;3;5;29098;225;112;113;0;28873;13633;15240
321100;"policki";"zachodniopomorskie";59;59;60614;61856;14473;46141;20;46161;83;1195;19;3;0;1;0;15;46155;15;4;46151;427;210;217;0;45724;16082;29642
321200;"pyrzycki";"zachodniopomorskie";36;36;27842;28073;9869;17973;7;17980;47;339;7;0;0;0;0;7;17979;7;5;17974;150;75;75;0;17824;10302;7522
321300;"sławieński";"zachodniopomorskie";73;73;45448;46192;13821;31627;13;31640;54;5539;13;0;0;0;0;13;31637;13;0;31637;286;171;115;0;31351;15021;16330
321400;"stargardzki";"zachodniopomorskie";105;105;86899;88295;26764;60133;18;60151;151;970;18;0;0;0;0;18;60148;18;5;60143;491;258;233;0;59652;27189;32463
321500;"szczecinecki";"zachodniopomorskie";75;75;54801;54630;20086;34715;18;34733;113;1010;18;0;0;0;0;18;34729;18;1;34728;290;136;154;0;34438;16672;17766
321600;"świdwiński";"zachodniopomorskie";45;45;33518;33233;12831;20687;1;20688;56;902;1;0;0;0;0;1;20687;1;0;20687;197;102;95;0;20490;9948;10542
321700;"wałecki";"zachodniopomorskie";46;46;37408;37313;13351;24057;8;24065;63;481;8;0;0;0;0;8;24063;8;1;24062;238;125;113;0;23824;10311;13513
321800;"łobeski";"zachodniopomorskie";32;32;25452;25473;10129;15323;18;15341;56;337;18;3;0;0;0;15;15337;15;4;15333;144;73;71;0;15189;7428;7761
326100;"Koszalin";"zachodniopomorskie";56;56;77006;76751;21301;55709;43;55752;123;1778;40;1;0;0;0;39;55736;38;1;55735;454;266;188;0;55281;19859;35422
326200;"Szczecin";"zachodniopomorskie";210;210;274433;280400;65125;209014;184;209198;340;5166;179;5;3;0;0;171;209172;171;26;209146;1974;1024;950;0;207172;74229;132943
326300;"Świnoujście";"zachodniopomorskie";28;28;31410;31972;8272;23135;9;23144;33;3228;9;0;0;0;0;9;23146;9;0;23146;173;94;79;0;22973;8265;14708
